1111111111111
10010C0001C11
111E010011001
1P101100E1001
1111111111111
