11111111111
1P0000C10E1
1000X1110X1
1C001100001
1X0110000X1
110000000C1
11111111111