11111111111111111111
1P000C1E00C000000001
1C0000010X00000X0001
10000000100000X00001
10000C00000000000001
10000000000000000001
1000000000000X000001
10000000000000000001
10XC000000C000000C01
10000000000000000001
1000C000000000C00001
10000000000000000001
11111111111111111111